02 03 04 06 05
9 8
040404040704040404
020101010106010602
030101010105010503
020101010101010102
030101010106010603
020101010105010502
030101010101010103
010101000001010101
