040404040704040404
010601010106010601
010501010105010501
010101010101010101
010601010106010601
010501010105010501
010101010101010101
010101000001010101
